CIkIlmayacaktI	CIk Il ma yacak tI
CIkarIna	CIkar I na, CIkar In a
CIkartIlIr	CIkar t Il Ir
CIkrIklarIn	CIkrIk lar In
CIrpIp	CIrp Ip
COreklerden	COrek ler den
COzebilirler	COz ebil ir ler
CaGIrdIklarInI	CaGIr dIk lar I nI, CaGIr dIk lar In I, CaGIr dIk larI nI
CabalIyorsun	Caba lIyor sun
CalISIlamamIS	Cal IS Il ama mIS, CalIS Il ama mIS
CalISmasIn	Cal IS ma sIn, CalIS ma sIn
CalayIm	Cal a yIm, Cala yIm
CantasIz	Canta sIz
CarpIlmanIz	Carp Il man Iz, Carp Il ma nIz
CatalcayI	Catalca yI
CeSnilerin	CeSni ler in
Cekilirdik	Cek il ir di k
Cekmemesi	Cek me me si
Cenede	Cened e, Cene de
Cevirmektir	Cevir mek tir
CiCeklerinden	CiCek ler in den, CiCek ler i nden, CiCek leri nden
Cindeydi	Cin de ydi
Cizgisine	Ciz gi si ne
CobanlIGa	Coban lIG a
CubuGa	CubuG a
IlImlIlIGInI	IlIm lI lIG I nI, IlIm lI lIG In I
IsItISIn	IsIt IS In
IzdIrabI	IzdIrab I
OGrenemeyeceGimi	OGren eme yeceG im i
OGretisi	OGreti si
OdediGinizi	Ode diG iniz i
Ofkelendiler	Ofke len di ler
OlCeGinde	OlCeG i nde, OlCeG in de
OldUrUyorlarsa	Ol dUr Uyor lar sa
OlmeyeceGine	Ol me yeceG in e, Ol me yeceG i ne
Onemsemeli	Onemse meli, Onemse me li
OngOrUlmekte	OngOr Ul mek te, OngOr Ul mekte
OpUSUyordu	Op US Uyor du
OrgUtlemesiyle	OrgUt le me si yle
OrtUlmUStUr	Or t Ul mUS tUr, Ort Ul mUS tUr
OvUnmektedir	Ov Un mekte dir, Ov Un mek te dir
Ozcanla	Ozcan la
Ozendirmek	Ozen dir mek, Oze n dir mek
OzgUvenli	OzgUven li
SIkI	SIk I
SaSIlIGInI	SaSI lIG In I, SaSI lIG I nI
SahIsI	SahIs I
Saklatarak	Sak lat arak
SarabI	Sarab I
Sebekesine	Sebeke si ne
SekillendirilmiStir	Sekil len dir il miS tir
Serifdeki	Serif de ki
SiSmanlatmaz	SiSman lat maz
Sirinyerdeki	Sirinyer de ki
Suurumuza	Suur umuz a
UleStirildiGi	U leS tir il diG i, UleS tir il diG i
Universitelerle	Universite ler le
Uretilmesini	Uret il me si ni, Ure t il me si ni
UskUfUnU	UskUf U nU, UskUf Un U
UtopyacIlIkla	Utopya cI lIk la
Uzerindekilerin	Uzer i nde ki ler in, Uzeri n de ki ler in, Uzer in de ki ler in
aCIklayIp	aCIk la yIp
aCabileceGine	aC abil eceG i ne, aC abil eceG in e
aGIrlIGImIz	aGIr lIG Im Iz, aGIr lIG ImIz
aGartmaya	aGar t ma ya
aGzImIzdan	aGz ImIz dan
aSaGIdaGdereliler	aSaGIdaGdere li ler
aSmIStI	aS mIS tI
abimi	abi m i
acelecilikten	acele ci lik ten
adamISlIGI	ada mIS lIG I
adetleriyle	adet ler i yle, adet leri yle
affetmedi	affet me di
ahlakdISIlIk	ahlakdISI lIk
akISIkIn	akISIk In
akadIn	akad In
aklamaktan	ak la mak tan
aksimizde	aks imiz de, aksi miz de
aktedilecek	akted il ecek
alISmadIGIm	alIS ma dIG Im, al IS ma dIG Im
alIndIGIndaysa	al In dIG In da ysa, al In dIG I nda ysa
alacaklIlIk	al acak lI lIk
alaylarInI	alay lar I nI, alay lar In I, alay larI nI
aldattIGInIzI	aldat tIG InIz I
algIlanabilme	algI lan abil me, al gI lan abil me
allahlarI	allah lar I, allah larI
altISar	altISar
amaClarImIz	amaC lar ImIz, amaC lar Im Iz
amerikasIz	amerika sIz
anImsatmadan	anImsa t ma dan, anImsa t madan
anamadIm	an ama dI m
animi	ani m i
anlaSmamIzI	an laS ma mIz I, anlaS ma mIz I
anlarInIn	an lar In In, an larI nIn, an lar I nIn
anlatmadInIz	an lat ma dI nIz, anla t ma dI nIz
anneanne	anneanne
antitezi	antitez i
arIndIrIyorlar	arIn dIr Iyor lar
araStIrmacIlarla	araStIr ma cI lar la
aralayacaktI	ara la yacak tI
arayISlarIndan	ara yIS lar I ndan, ara yIS lar In dan, ara yIS larI ndan
arkadaSlarImIn	arkadaS lar Im In
artIdayIz	artI da yIz
arttIramIyor	art tIr amIyor
asIrlardIr	asIr lar dIr, as Ir lar dIr
aslIndan	as lIn dan, asl I ndan, asl In dan
atIlImIm	atIl Im Im, at Il Im Im
atalarImIz	ata lar Im Iz, ata lar ImIz
ateSleri	ateS ler i, ateS leri
atlattIn	atla t tI n, atla t t In, at lat t In, at lat tI n
avSara	avSar a
avucunu	avuc un u, avuc u nu
